va=ヴぁ
vi=ヴぃ
vu=ヴぅ
ve=ヴぇ
vo=ヴぉ
kya=きゃ
kyu=きゅ
kye=きぇ
kyo=きょ
gya=ぎゃ
gyu=ぎゅ
gye=ぎぇ
gyo=ぎょ
sha=しゃ
shu=しゅ
she=しぇ
sho=しょ
ja=じゃ
ju=じゅ
je=じぇ
jo=じょ
cha=ちゃ
chu=ちゅ
che=ちぇ
cho=ちょ
tsa=つぁ
tsi=つぃ
tse=つぇ
tso=つぉ
nya=にゃ
nyu=にゅ
nye=にぇ
nyo=にょ
hya=ひゃ
hyu=ひゅ
hye=ひぇ
hyo=ひょ
pya=ぴゃ
pyu=ぴゅ
pye=ぴぇ
pyo=ぴょ
bya=びゃ
byu=びゅ
bye=びぇ
byo=びょ
mya=みゃ
myu=みゅ
mye=みぇ
myo=みょ
ye=いぇ
rya=りゃ
ryu=りゅ
rye=りぇ
ryo=りょ
ti=てぃ
tu=とぅ
fa=ふぁ
fi=ふぃ
fe=ふぇ
fo=ふぉ
si=すぃ
zi=ずぃ
di=でぃ
du=どぅ
dyu=でゅ
tu=とぅ
wi=うぃ
we=うぇ
a=あ
i=い
u=う
e=え
o=お
ka=か
ki=き
ku=く
ke=け
ko=こ
sa=さ
shi=し
su=す
se=せ
so=そ
ta=た
chi=ち
tsu=つ
te=て
to=と
na=な
ni=に
nu=ぬ
ne=ね
no=の
ha=は
hi=ひ
fu=ふ
he=へ
ho=ほ
ma=ま
mi=み
mu=む
me=め
mo=も
ya=や
yu=ゆ
yo=よ
ra=ら
ri=り
ru=る
re=れ
ro=ろ
wa=わ
n=ん
N=ん
ga=が
gi=ぎ
gu=ぐ
ge=げ
go=ご
za=ざ
ji=じ
zu=ず
ze=ぜ
zo=ぞ
da=だ
de=で
do=ど
pa=ぱ
pi=ぴ
pu=ぷ
pe=ぺ
po=ぽ
ba=ば
bi=び
bu=ぶ
be=べ
bo=ぼ
